11111111111111111111111111111111111
1111         1   d   1         1111
1  0 e       1 e 1 e 1       e 0  1
1111         1  010  1         1111
1  0         0   1   0         0  1
1  0                           0  1
1  0            000            0  1
110111  111111  000  111111  111011
1    1  1    0  000  0    1  1    1
11   1111    111111111    1111   11
1    1  1                 1  1    1
1  111  1111           1111  111  1
1  0       1           1       0  1
1  0       1           1       0  1
1  0       1           1       0  1
1  0       11111   11111       0  1
1  0         0   p   1         0  1
1  0         0  000  1         0  1
1f11         0  0b0  0         11f1
11111111111111111111111111111111111