11111111111111111111111111111111111
1111         1   d   1         1111
1  0 e       1 e 1 e 1       e 0  1
1111         1  010  1         1111
1            0   1   0            1
1                                 1
1               000               1
1  000  000     000     000  000  1
1    1  1    0  000  0    1  1    1
1    1111    111111111    1111    1
1    1  1                 1  1    1
1  000  000             000  000  1
1                                 1
1                                 1
1                                 1
1           1111   1111           1
1            0   p   1            1
1            0  000  1            1
1f11         0  0b0  0         11f1
11111111111111111111111111111111111