11111111111111111111111111111111111
1                                 1
1                                 1
1               000               1
1              00b00              1
1             1111111             1
1                                 1
1000                           0001
1e                               e1
111                             111
1                                 1
1                                 1
1                                 1
1                                 1
1           11111111111           1
1           1110000               1
1             0 1 1               1
1             1 1 11111           1
1             1f1p1f  0           1
11111111111111111111111111111111111