11111111111111111111111111111111111
1f0                             1e1
100                             001
1                                 1
1                                 1
1                                 1
1                                 1
1                                 1
1               000               1
1               0b0               1
1               0p0               1
1               000               1
1                                 1
1                                 1
1                                 1
1                                 1
1                                 1
100                             001
1e1                             0f1
11111111111111111111111111111111111