0000000000000000000000000000000000000
00                                 00
0                                   0
0                                   0
0                                   0
0                                   0
0                                   0
0                                   0
0                                   0
0                                   0
0                                   0
0                                   0
0                                   0
0                                   0
0                                   0
0                                   0
0                1 1                0
0                000                0
00               0 0               00
0000000000000000000000000000000000000