00000000000000000000000000000000000000
00                                  00
0                                    0
0                                    0
0                                    0
0                                    0
0                                    0
0                                    0
0                                    0
0                                    0
0                                    0
0                                    0
0                                    0
0                                    0
0                                    0
0                                    0
0                1  1                0
0                0000                0
00               0  0               00
00000000000000000000000000000000000000