11111111111111111111111111111111111
1    1                       1    1
1           00000000000           1
1 e e       1         1       e e 1
1           1         1           1
1    1                       1    1
100000      0   000   0      000001
1                                 1
1                                 1
1                                 1
1    0000000           0000000    1
1   1   0   1         1   0   1   1
1       0                 0       1
11      0                 0      11 
1       000000       000000       1
1       0       000       0       1
1       0       0p0       0       1
1       0     f01110f     0       1
1       0        b        0       1
11111111111111111111111111111111111