11111111111111111111111111111111111
1011                           1101
1111                           1111
1           00  000  00           1
1            0 00b00 0            1
1            011111110            1
1000                           0001
1   1      1111     1111      1   1
1e           10     01           e1
1   10        0     0        01   1
111110                       011111
1                                 1
1                                 1
1                                 1
1     100                 001     1
1       0     000000000   0       1
1       0     0 0     0   0       1
100000000     1 1 11111   000000001
1             1f1p1f  0           1
11111111111111111111111111111111111