11111111111111111111111111111111111
1        0               0        1
1        0      000      0        1
1        0      0b0      0        1
1        00111111111111100        1
1         11           11         1
1        1              p1        1
1        1111         1111        1
1            1       1            1
1             1     1             1
1             1     1             1
1    1        1000001        1    1
1    1        1     1        1    1
1    1                       1    1
1    1                       1    1
1  101     1           1     101  1
1  1 1     1           1     1 1  1
1001 1     1111111111111     1 1001
1  1e1         f 1 f         1e1  1
11111111111111111111111111111111111