11111111111111111111111111111111111
1                                 1
1                                 1
1                                 1
1                                 1
1                                 1
1                                 1
1        000           000        1
1000000000e0000000000000e0000000001
1        0 0           0 0        1
1                                 1
1                                 1
1                                 1
1                                 1
1                                 1
1                                 1
1                p                1
100             000             001
1f0             0b0             0f1
11111111111111111111111111111111111
