11111111111111111111111111111111111
1                              0111
1                             e0111
10000000000              0     0001
1         1               0     e 1
1         1               0       1
1         1                0      1
1              0   0        0     1
1              0   0         00   1
1              0   0           0  1
1  0           01110              1
1   00         0   0              1
1     0        0   0              1
1      0       0   0    1         1
1       0               1         1
1       0               1         1
1 fp     0              00000000001
100f                              1
1b0                               1
11111111111111111111111111111111111
