1111111111111111111111111111111111111
11                                 11
1                                   1
1                                   1
1                                   1
1                                   1
1                                   1
1                                   1
1                                   1
1                                   1
1                                   1
1                                   1
1                                   1
1                                   1
1                                   1
1                                   1
1                1 1                1
1                000                1
11               0 0               11
1111111111111111111111111111111111111