11111111111111111111111111111111111
1                                 1
1                                 1
1                                 1
1                                 1
1                                 1
1                                 1
1                  000          001
1                  0e0           f1
1                              1111
1111                              1
1e           0f0                  1
100          000                  1
1                                 1
1                                 1
1               000               1
1               0b0               1
1          0000011100000          1
1                p                1
11111111111111111111111111111111111