11111111111111111111111111111111111
11eeee                       eeee11
1                                 1
10000000000000000   000000000000001
1                                 1
1                                 1
1                                 1
1                                 1
1                                 1
1                                 1
1                                 1
111111                       111111
1                                 1
1                                 1
1               0 0               1
1               0 0               1
1               1p1               1
1               000               1
11             f0 0f            11
11111111111111111111111111111111111