11111111111111111111111111111111111
11                               11
1  e                           e  1
1                                 1
100000000000000     000000000000001
1                                 1
1                                 1
1                                 1
1                                 1
1                                 1
1                                 1
111111                       111111
1                                 1
1                                 1
1               0 0               1
1               0 0               1
1               1p1               1
1               000               1
11             f0b0f             11
11111111111111111111111111111111111