11111111111111111111111111111111111
1           1 1  b  1 1           1
1           1f1  p  1f1           1
1      0    1 1     1 1    0      1
1      0    1 1     1 1    0      1
1      0    0         0    0      1
1      111111         111111      1
1        1               1        1
1        1               1        1
1        1     00000     1        1
1        1     00000     1        1
1        1               1        1
1        1               1        1
1      111111         111111      1
1      0    0         0    0      1
1      0    1    0    1    0      1
1      0    1    1    1    0      1
1           1    1    1           1
1           1   e1e   1           1
11111111111111111111111111111111111