11111111111111111111111111111111111
1f             0           0      1
1              1           0    e 1
1              0           0011   1
1              1                  1
1       00000000                  1
1                                 1
1                                 1
1                        1        1
100                      0000000  1
1b0p                     1        1
100                      0000000  1
1                        1        1
1                                 1
1                      00         1
1        0            0           1
1        0           0            1
1        0           0          e 1
1f       0                        1
11111111111111111111111111111111111