11111111111111111111111111111111111
1      1            1           0d1
1 eeee 1     eeee   0        ee 001
1                   1      1      1
1000000     000000000      00000001
1                                 1
1     000000000                   1
1     000000000                   1
1     000000000            11     1
1                  111111  00     1
1     010101010    111111  00    11
1     101010101            00     1
1                          00     1
1         1000001110000000000     1
1         1000001110000000000     1
1         00                      1
1         00     p                1
1               000               1
10f1            0b0            1f01
11111111111111111111111111111111111