11111111111111111111111111111111111
1                                 1
1                                 1
1         000         000         1
1         0e0         0e0         1
1         000         000         1
1                                 1
1                                 1
1                                 1
1                                 1
1                                 1
100000000   00000000000   000000001
10f0                           0f01
1000                           0001
1                                 1
1                                 1
1               0p0               1
1               000               1
1               0b0               1
11111111111111111111111111111111111